nukku	nuku
pankki	panki
oppi	opi
lippu	lipu
otta	ota
tyttö	tytö
luke	lue
hanka	hanga
helsinki	helsingin
saapu	saavu
leipä	leivä
kylpe	kylve
halpa	halva
arpo	arvo
kampa	kamma
löytä	löydä
katu	kadu
tahto	tahdo
kieltä	kiellä
silta	sillan
ymmärtä	ymmärrä
kerta	kerra
anta	anna
ranta	ranna
karka	kara
arka	aran
kylki	kylje
kulke	kulje
järki	järje
särkeä	särje
vehke	vehje
rohke	rohje
puku	puvu
kyky	kyvy
jalka	jala